#####################
#...................#
#...................#
#...................#
#...................#
#...................#
#........###........#
#.........r.........#
#........#d#........#
#.......#bpo#.......#
#........###........#
#...................#
#...................#
#...................#
#...................#
#.........c.........#
#...................#
#...................#
#...................#
#...................#
#####################