_###################_
_#........#........#_
_#*##.###.#.###.##*#_
_#.................#_
_#.##.#.#####.#.##.#_
_#....#...#...#....#_
_####.###_#_###.####_
____#.#___r___#.#____
#####.#_##d##_#.#####
_____.__#bpo#__._____
#####.#_#####_#.#####
____#.#_______#.#____
_####.###_#_###.####_
_#........#........#_
_#.##.###.#.###.##.#_
_#*.#.....c.....#.*#_
_##.#.#.#####.#.#.##_
_#....#...#...#....#_
_#.######.#.######.#_
_#.................#_
_###################_